[
  {
    "type": "mapgen",
    "method": "json",
    "om_terrain": [
      [ "railroad_station_1_3", "railroad_station_1_2", "railroad_station_1_1" ],
      [ "railroad_station_1_6", "railroad_station_1_5", "railroad_station_1_4" ],
      [ "railroad_station_1_9", "railroad_station_1_8", "railroad_station_1_7" ]
    ],
    "weight": 100,
    "object": {
      "fill_ter": "t_dirt",
      "rows": [
        "                    |||||||^^X^^X^^  ^^X^^X^^|||||||                    ",
        "                    |______^#x##x#^  ^#x##x#^______|                    ",
        "                    |______^^X^^X^^  ^^X^^X^^______|                    ",
        "                    |______^^X^^X^^  ^^X^^X^^______|                    ",
        "                    |______^#x##x#^  ^#x##x#^______|                    ",
        "                    |______^^X^^X^^  ^^X^^X^^______|                    ",
        "                    |______^^X^^X^^  ^^X^^X^^______|                    ",
        "                    |______^#x##x#^  ^#x##x#^______|                    ",
        "                    |______^^X^^X^^  ^^X^^X^^______|                    ",
        "                    |______^^X^^X^^  ^^X^^X^^______|                    ",
        "                    |______^#x##x#^  ^#x##x#^______|                    ",
        "                    |______^^X^^X^^  ^^X^^X^^______|                    ",
        "                    |______^^X^^X^^  ^^X^^X^^______|                    ",
        "                    |______^#x##x#^  ^#x##x#^______|                    ",
        "                    |______^^X^^X^^  ^^X^^X^^______|                    ",
        "                    |______^^X^^X^^  ^^X^^X^^______|                    ",
        "                    |______^#x##x#^  ^#x##x#^______|                    ",
        "                    |______^^X^^X^^  ^^X^^X^^______|                    ",
        "                    |______^^X^^X^^  ^^X^^X^^______|                    ",
        "                    |______^#x##x#^  ^#x##x#^______|                    ",
        "                    |______^^X^^X^^  ^^X^^X^^______|                    ",
        "                    |______^^X^^X^^  ^^X^^X^^______|                    ",
        "                    |______^#x##x#^  ^#x##x#^______|                    ",
        "                    |______^^X^^X^^  ^^X^^X^^______|                    ",
        "                    |______^^X^^X^^  ^^X^^X^^______|                    ",
        "                    |______^#x##x#^  ^#x##x#^______|                    ",
        "                    |______^^X^^X^^  ^^X^^X^^______|                    ",
        "                    |______^^X^^X^^  ^^X^^X^^______|                    ",
        "                    |______^#x##x#^  ^#x##x#^______|                    ",
        "                    |______^^X^^X^^  ^^X^^X^^______|                    ",
        "                    |______^^X^^X^^  ^^X^^X^^______|                    ",
        "                    |______^#x##x#^  ^#x##x#^______|                    ",
        "                    |______^^X^^X^^  ^^X^^X^^______|                    ",
        "                    |______^^X^^X^^  ^^X^^X^^______|                    ",
        "                    |______^#x##x#^  ^#x##x#^______|                    ",
        "                    |______^^X^^X^^  ^^X^^X^^______|                    ",
        "                    |______^^X^^X^^  ^^X^^X^^______|                    ",
        "                    |______^#x##x#^  ^#x##x#^______|                    ",
        "                    |______^^X^^X^^  ^^X^^X^^______|                    ",
        "                    |______^^X^^X^^  ^^X^^X^^______|                    ",
        "                    |______^#x##x#^  ^#x##x#^______|                    ",
        "                    |______^^X^^X^^  ^^X^^X^^______|                    ",
        "                    |______^^X^^X^^  ^^X^^X^^______|                    ",
        "                    |______^#x##x#^  ^#x##x#^______|                    ",
        "                    |______^^X^^X^^  ^^X^^X^^______|                    ",
        "                    |______^^X^^X^^  ^^X^^X^^______|                    ",
        "                    |______^#x##x#^  ^#x##x#^______|                    ",
        "                    |______^^X^^X^^  ^^X^^X^^______|                    ",
        "                    |______^^X^^X^^  ^^X^^X^^______|                    ",
        "                    |______^#x##x#^  ^#x##x#^______|                    ",
        "                    |______^^X^^X^^  ^^X^^X^^______|                    ",
        "                    |______^^X^^X^^  ^^X^^X^^______|                    ",
        "                    |______^#x##x#^  ^#x##x#^______|                    ",
        "                    |______^^X^^X^^  ^^X^^X^^______|                    ",
        "                    |______^^X^^X^^  ^^X^^X^^______|                    ",
        "                    |______^#x##x#^  ^#x##x#^______|                    ",
        "                    |______^^X^^X^^  ^^X^^X^^______|                    ",
        "                    |______^^X^^X^^  ^^X^^X^^______|                    ",
        "                    |______^#x##x#^  ^#x##x#^______|                    ",
        "                    |______^^X^^X^^  ^^X^^X^^______|                    ",
        "                    |______^^X^^X^^  ^^X^^X^^______|                    ",
        "                    |______^#x##x#^  ^#x##x#^______|                    ",
        "                    |______^^X^^X^^  ^^X^^X^^______|                    ",
        "                    |______^^X^^X^^  ^^X^^X^^______|                    ",
        "                    |______^#x##x#^  ^#x##x#^______|                    ",
        "                    |______^^X^^X^^  ^^X^^X^^______|                    ",
        "                    |______^^X^^X^^  ^^X^^X^^______|                    ",
        "                    |______^#x##x#^  ^#x##x#^______|                    ",
        "                    |______^^X^^X^^  ^^X^^X^^______|                    ",
        "                    |______^^X^^X^^  ^^X^^X^^______|                    ",
        "                    |______^#x##x#^  ^#x##x#^______|                    ",
        "                    |||||||^^X^^X^^  ^^X^^X^^|||||||                    "
      ],
      "palettes": [
        "railroad"
      ]
    }
  }
]
