[
  {
    "type": "mapgen",
    "method": "json",
    "om_terrain": [ [ "railroad_station_1_1", "railroad_station_1_2" ], [ "railroad_station_1_3", "railroad_station_1_4" ] ],
    "weight": 100,
    "object": {
      "fill_ter": "t_dirt",
      "rows": [
        "^^X^^^Xrrrrrrrrrr                               ",
        "^txtttxr&bbbbb&_r ]]]]]]]]]]]]]]]]]]]]]]]]]]]]]]",
        "^^X^^^Xr______b_r ]]]]]]]].....................]",
        "^^X^^^Xr______b_r ]]]]]]]].....................]",
        "^tXtttX_______b_r ]]]]]]]].....................]",
        "^^X^^^X_______b_r ]]]]]]]].....................]",
        "^^X^^^X_______b_r ]]]]]]]]::::::.........::::::]",
        "^tXtttX_______&_r ]]]]]]]].....................]",
        "^^X^^^X_______b_r ]]]]]]]].....................]",
        "^^X^^^X_______b_r ]]]]]]]].....................]",
        "^tXtttX_______b_r ]]]]]]]].....................]",
        "^^X^^^X_______b_r ]]]]]]]]::::::.........::::::]",
        "^^X^^^X_______b_r ]]]]]]]].....................]",
        "^tXtttX_______&_rr____rr ].....................]",
        "^^X^^^X_______________&r ].....................]",
        "^^X^^^X________________r ].....................]",
        "^tXtttX________________r ]::::::.........::::::]",
        "^^X^^^X________________r ].....................]",
        "^^X^^^X________________r ].....................]",
        "^tXtttX_________8#+###+# ].....................]",
        "^^X^^^X_________&#[s#s[# ].....................]",
        "^^X^^^X_________9#[T#T[# ]::::::.........::::::]",
        "^tXtttX____##+#O######## ].....................]",
        "^^X^^^X____#l[[ddd[#fff# ].....................]",
        "^^X^^^X____#l[[[c[[#[[[# ].....................]",
        "^txtttx____#l[[[[[[+[[[+]].....................]",
        "^^X^^^X____#[[[[[[[#[[d# ]::::::.........::::::]",
        "^^X^^^X____#c^c^c^c#[cdO ].....................]",
        "^tXtttX____#C^C^C^C#[[d# ].....................]",
        "^^X^^^X____#O#O#O#O##O## ].....................]",
        "^^X^^^X________________r ].....................]",
        "^tXtttX________________r ]::::::.........::::::]",
        "^^X^^^X________________r ].....................]",
        "^^X^^^X_______________&r ].....................]",
        "^tXtttX_______&_rr____rr ].....................]",
        "^^X^^^X_______b_r ]]]]   ].....................]",
        "^^X^^^X_______b_r ]]]]]]]]::::::.........::::::]",
        "^tXtttX_______b_r ]]]]]]]].....................]",
        "^^X^^^X_______b_r ]]]]]]]].....................]",
        "^^X^^^X_______b_r ]]]]]]]].....................]",
        "^tXtttX_______&_r ]]]]]]]].....................]",
        "^^X^^^X_______b_r ]]]]]]]]::::::.........::::::]",
        "^^X^^^X_______b_r ]]]]]]]].....................]",
        "^tXtttX_______b_r ]]]]]]]].....................]",
        "^^X^^^Xr______b_r ]]]]]]]].....................]",
        "^^S^^^Sr______b_r ]]]]]]]].....................]",
        "^^^^^^^r&bbbbb&_r ]]]]]]]]::::::.........::::::]",
        "^^^^^^^rrrrrrrrrr        ].....................]"
      ],
      "palettes": [ "railroad", "railroad_station" ],
      "vendingmachines": { "8": { "item_group": "vending_drink" }, "9": { "item_group": "vending_food" } }
    }
  },
  {
    "type": "mapgen",
    "method": "json",
    "om_terrain": [ "railroad_station_single" ],
    "weight": 100,
    "object": {
      "fill_ter": "t_floor",
      "rows": [
        "^^X^^^Xrrrr#############",
        "^txtttxr___+[[[[[[[+[[[+",
        "^^X^^^X___8#[[[[[[[#[[d#",
        "^^X^^^X___9#c^c^c^c#[cdO",
        "^tXtttX___8#C^C^C^C#[[d#",
        "^^X^^^X___&#O#O#O#O#####",
        "^^X^^^X________________#",
        "^tXtttX________________r",
        "^^X^^^X________________r",
        "^^X^^^X__________&____&r",
        "^tXtttX_________rr____rr",
        "^^X^^^X__&bbbbb_r ____  ",
        "^^X^^^X_________r ______",
        "^tXtttX__&bbbbb_r ______",
        "^^X^^^X_________r ______",
        "^^X^^^X__&bbbbb_r ______",
        "^tXtttX_________r ______",
        "^^X^^^X__&bbbbb_r ______",
        "^^X^^^X_________r ______",
        "^tXtttXr_&bbbbb_r ______",
        "^^X^^^Xr________r ______",
        "^^S^^^Sr_&bbbbb_r ______",
        "^^^^^^^r________r ______",
        "^^^^^^^rrrrrrrrrr       "
      ],
      "palettes": [ "railroad", "railroad_station" ],
      "vendingmachines": { "8": { "item_group": "vending_drink" }, "9": { "item_group": "vending_food" } }
    }
  }
]
