[
  {
    "type": "mapgen",
    "method": "json",
    "om_terrain": [ "railroad_station" ],
    "weight": 100,
    "object": {
      "fill_ter": "t_dirt",
      "rows": [
        "........................",
        ".w.HHHHHHHHHHHHHHHHHH.w.",
        "...^^x^^^x^^^^x^^^x^^...",
        ".m.^-x---x-^^-x---x-^.m.",
        "...^^x^^^x^^^^x^^^x^^...",
        "...^-x---x-^^-x---x-^...",
        "...^^x^^^x^^^^x^^^x^^...",
        "...^-x---x-^^-x---x-^...",
        "...^^x^^^x^^^^x^^^x^^...",
        "...^-x---x-^^-x---x-^...",
        "...^^x^^^x^^^^x^^^x^^...",
        "...^-x---x-^^-x---x-^...",
        "...^^x^^^x^^^^x^^^x^^...",
        "...^-x---x-^^-x---x-^...",
        "...^^x^^^x^^^^x^^^x^^...",
        "...^-x---x-^^-x---x-^...",
        "...^^x^^^x^^^^x^^^x^^...",
        "...^-x---x-^^-x---x-^...",
        ".V.^^x^^^x^^^^x^^^x^^.V.",
        ".V.^-x---x-^^-x---x-^.V.",
        ".V.^^x^^^x^^^^x^^^x^^.V.",
        ".V.^-x---x-^^-x---x-^.V.",
        ".V.^^x^^^x^^^^x^^^x^^.V.",
        "...^-x---x-^^-x---x-^..."
      ],
      "palettes": [
        "railroad"
      ]
    }
  }
]
