[
  {
    "type": "mapgen",
    "method": "json",
    "om_terrain": [ [ "railroad_station_1_1", "railroad_station_1_2" ], [ "railroad_station_1_3", "railroad_station_1_4" ] ],
    "weight": 100,
    "object": {
      "fill_ter": "t_dirt",
      "rows": [
        "^^X^^^Xrrrrrrrrrr                               ",
        "^txtttxr&bbbbb&_r ]]]]]]]]]]]]]]]]]]]]]]]]]]]]]]",
        "^^X^^^Xr______b_r ]]]]]]]].....................]",
        "^^X^^^Xr______b_r ]]]]]]]].....................]",
        "^txtttx_______b_r ]]]]]]]].....................]",
        "^^X^^^X_______b_r ]]]]]]]].....................]",
        "^^X^^^X_______b_r ]]]]]]]]::::::.........::::::]",
        "^txtttx_______&_r ]]]]]]]].....................]",
        "^^X^^^X_______b_r ]]]]]]]].....................]",
        "^^X^^^X_______b_r ]]]]]]]].....................]",
        "^txtttx_______b_r ]]]]]]]].....................]",
        "^^X^^^X_______b_r ]]]]]]]]::::::.........::::::]",
        "^^X^^^X_______b_r ]]]]]]]].....................]",
        "^txtttx_______&_rr____rr ].....................]",
        "^^X^^^X_______________&r ].....................]",
        "^^X^^^X________________r ].....................]",
        "^txtttx________________r ]::::::.........::::::]",
        "^^X^^^X________________r ].....................]",
        "^^X^^^X________________r ].....................]",
        "^txtttx_________8#+###+# ].....................]",
        "^^X^^^X_________&#[s#s[# ].....................]",
        "^^X^^^X_________9#[T#T[# ]::::::.........::::::]",
        "^txtttx____##+#O######## ].....................]",
        "^^X^^^X____#l[[ddd[#fff# ].....................]",
        "^^X^^^X____#l[[[c[[#[[[# ].....................]",
        "^txtttx____#l[[[[[[+[[[+]].....................]",
        "^^X^^^X____#[[[[[[[#[[d# ]::::::.........::::::]",
        "^^X^^^X____#c^c^c^c#[cdO ].....................]",
        "^txtttx____#C^C^C^C#[[d# ].....................]",
        "^^X^^^X____#O#O#O#O##O## ].....................]",
        "^^X^^^X________________r ].....................]",
        "^txtttx________________r ]::::::.........::::::]",
        "^^X^^^X________________r ].....................]",
        "^^X^^^X_______________&r ].....................]",
        "^txtttx_______&_rr____rr ].....................]",
        "^^X^^^X_______b_r ]]]]   ].....................]",
        "^^X^^^X_______b_r ]]]]]]]]::::::.........::::::]",
        "^txtttx_______b_r ]]]]]]]].....................]",
        "^^X^^^X_______b_r ]]]]]]]].....................]",
        "^^X^^^X_______b_r ]]]]]]]].....................]",
        "^txtttx_______&_r ]]]]]]]].....................]",
        "^^X^^^X_______b_r ]]]]]]]]::::::.........::::::]",
        "^^X^^^X_______b_r ]]]]]]]].....................]",
        "^txtttx_______b_r ]]]]]]]].....................]",
        "^^X^^^Xr______b_r ]]]]]]]].....................]",
        "^^S^^^Sr______b_r ]]]]]]]].....................]",
        "^^^^^^^r&bbbbb&_r ]]]]]]]]::::::.........::::::]",
        "^^^^^^^rrrrrrrrrr        ].....................]"
      ],
      "palettes": [ "railroad", "railroad_station" ],
      "vendingmachines": { "8": { "item_group": "vending_drink" }, "9": { "item_group": "vending_food" } }
    }
  },
  {
    "type": "mapgen",
    "method": "json",
    "om_terrain": [ "railroad_station_single" ],
    "weight": 100,
    "object": {
      "fill_ter": "t_floor",
      "rows": [
        "^^X^^^Xrrrr#############",
        "^txtttxr___+[[[[[[[+[[[+",
        "^^X^^^X___8#[[[[[[[#[[d#",
        "^^X^^^X___9#c^c^c^c#[cdO",
        "^txtttx___8#C^C^C^C#[[d#",
        "^^X^^^X___&#O#O#O#O#####",
        "^^X^^^X________________#",
        "^txtttx________________r",
        "^^X^^^X________________r",
        "^^X^^^X__________&____&r",
        "^txtttx_________rr____rr",
        "^^X^^^X__&bbbbb_r ____  ",
        "^^X^^^X_________r ______",
        "^txtttx__&bbbbb_r ______",
        "^^X^^^X_________r ______",
        "^^X^^^X__&bbbbb_r ______",
        "^txtttx_________r ______",
        "^^X^^^X__&bbbbb_r ______",
        "^^X^^^X_________r ______",
        "^txtttxr_&bbbbb_r ______",
        "^^X^^^Xr________r ______",
        "^^S^^^Sr_&bbbbb_r ______",
        "^^^^^^^r________r ______",
        "^^^^^^^rrrrrrrrrr       "
      ],
      "palettes": [ "railroad", "railroad_station" ],
      "vendingmachines": { "8": { "item_group": "vending_drink" }, "9": { "item_group": "vending_food" } }
    }
  }
]
