[
  {
    "type": "mapgen",
    "method": "json",
    "om_terrain": [ "railroad_station_1_1", "railroad_station_1_2", "railroad_station_1_3", "railroad_station_1_4" ],
    "weight": 100,
    "object": {
      "fill_ter": "t_dirt",
      "rows": [
        "................................................",
        ".w.HHHHHHHHHHHHHHHHHH.w..w.HHHHHHHHHHHHHHHHHH.w.",
        "...^^x^^^x^^^^x^^^x^^......^^x^^^x^^^^x^^^x^^...",
        ".m.^-x---x-^^-x---x-^.m..m.^-x---x-^^-x---x-^.m.",
        "...^^x^^^x^^^^x^^^x^^......^^x^^^x^^^^x^^^x^^...",
        "...^-x---x-^^-x---x-^......^-x---x-^^-x---x-^...",
        "...^^x^^^x^^^^x^^^x^^......^^x^^^x^^^^x^^^x^^...",
        "...^-x---x-^^-x---x-^......^-x---x-^^-x---x-^...",
        "...^^x^^^x^^^^x^^^x^^......^^x^^^x^^^^x^^^x^^...",
        "...^-x---x-^^-x---x-^......^-x---x-^^-x---x-^...",
        "...^^x^^^x^^^^x^^^x^^......^^x^^^x^^^^x^^^x^^...",
        "...^-x---x-^^-x---x-^......^-x---x-^^-x---x-^...",
        "...^^x^^^x^^^^x^^^x^^......^^x^^^x^^^^x^^^x^^...",
        "...^-x---x-^^-x---x-^......^-x---x-^^-x---x-^...",
        "...^^x^^^x^^^^x^^^x^^......^^x^^^x^^^^x^^^x^^...",
        "...^-x---x-^^-x---x-^......^-x---x-^^-x---x-^...",
        "...^^x^^^x^^^^x^^^x^^......^^x^^^x^^^^x^^^x^^...",
        "...^-x---x-^^-x---x-^......^-x---x-^^-x---x-^...",
        ".V.^^x^^^x^^^^x^^^x^^.V..V.^^x^^^x^^^^x^^^x^^.V.",
        ".V.^-x---x-^^-x---x-^.V..V.^-x---x-^^-x---x-^.V.",
        ".V.^^x^^^x^^^^x^^^x^^.V..V.^^x^^^x^^^^x^^^x^^.V.",
        ".V.^-x---x-^^-x---x-^.V..V.^-x---x-^^-x---x-^.V.",
        ".V.^^x^^^x^^^^x^^^x^^.V..V.^^x^^^x^^^^x^^^x^^.V.",
        "...^-x---x-^^-x---x-^......^-x---x-^^-x---x-^...",
        "................................................",
        ".w.HHHHHHHHHHHHHHHHHH.w..w.HHHHHHHHHHHHHHHHHH.w.",
        "...^^x^^^x^^^^x^^^x^^......^^x^^^x^^^^x^^^x^^...",
        ".m.^-x---x-^^-x---x-^.m..m.^-x---x-^^-x---x-^.m.",
        "...^^x^^^x^^^^x^^^x^^......^^x^^^x^^^^x^^^x^^...",
        "...^-x---x-^^-x---x-^......^-x---x-^^-x---x-^...",
        "...^^x^^^x^^^^x^^^x^^......^^x^^^x^^^^x^^^x^^...",
        "...^-x---x-^^-x---x-^......^-x---x-^^-x---x-^...",
        "...^^x^^^x^^^^x^^^x^^......^^x^^^x^^^^x^^^x^^...",
        "...^-x---x-^^-x---x-^......^-x---x-^^-x---x-^...",
        "...^^x^^^x^^^^x^^^x^^......^^x^^^x^^^^x^^^x^^...",
        "...^-x---x-^^-x---x-^......^-x---x-^^-x---x-^...",
        "...^^x^^^x^^^^x^^^x^^......^^x^^^x^^^^x^^^x^^...",
        "...^-x---x-^^-x---x-^......^-x---x-^^-x---x-^...",
        "...^^x^^^x^^^^x^^^x^^......^^x^^^x^^^^x^^^x^^...",
        "...^-x---x-^^-x---x-^......^-x---x-^^-x---x-^...",
        "...^^x^^^x^^^^x^^^x^^......^^x^^^x^^^^x^^^x^^...",
        "...^-x---x-^^-x---x-^......^-x---x-^^-x---x-^...",
        ".V.^^x^^^x^^^^x^^^x^^.V..V.^^x^^^x^^^^x^^^x^^.V.",
        ".V.^-x---x-^^-x---x-^.V..V.^-x---x-^^-x---x-^.V.",
        ".V.^^x^^^x^^^^x^^^x^^.V..V.^^x^^^x^^^^x^^^x^^.V.",
        ".V.^-x---x-^^-x---x-^.V..V.^-x---x-^^-x---x-^.V.",
        ".V.^^x^^^x^^^^x^^^x^^.V..V.^^x^^^x^^^^x^^^x^^.V.",
        "...^-x---x-^^-x---x-^......^-x---x-^^-x---x-^..."
      ],
      "palettes": [
        "railroad"
      ]
    }
  }
]
