[
  {
    "type": "mapgen",
    "method": "json",
    "om_terrain": [ "railroad_level_crossing" ],
    "weight": 100,
    "object": {
      "fill_ter": "t_dirt",
      "rows": [
        "^^X^^X^^                ",
        "^#x##x#^ m              ",
        "^^X^^X^^ 1              ",
        "^^X^^X^^                ",
        "..X..X..................",
        "..X..X..................",
        "..X..X..................",
        "..X..X..................",
        "..X..X..................",
        "..X..X..................",
        "..X..X..................",
        ":.X..X.:.:::.:::.:::.:::",
        ":.X..X.:.:::.:::.:::.:::",
        "..X..X..................",
        "..X..X..................",
        "..X..X..................",
        "..X..X..................",
        "..X..X..................",
        "..X..X..................",
        "..X..X..................",
        "^^X^^X^^                ",
        "^^X^^X^^ m              ",
        "^#x##x#^ 1              ",
        "^^X^^X^^                "
      ],
      "palettes": [
        "railroad"
      ]
    }
  }
]
