[
  {
    "type": "mapgen",
    "method": "json",
    "om_terrain": [
      "railroad_station_1"
    ],
    "weight": 100,
    "object": {
      "fill_ter": "t_dirt",
      "rows": [
        "^^X^^X^||||#############",
        "^-x--x-|___+.......+...#",
        "^^X^^X^___V#.......#...#",
        "^^X^^X^___V#c.c.c.c#.cDO",
        "^-x--x-___V#C.C.C.C#...#",
        "^^X^^X^___&#O#O#O#O#####",
        "^^X^^X^________________#",
        "^-x--x-________________|",
        "^^X^^X^________________|",
        "^^X^^X^__________&____&|",
        "^-x--x-_________||____||",
        "^^X^^X^__&bbbbb_| ____  ",
        "^^X^^X^_________| ______",
        "^-x--x-__&bbbbb_| ______",
        "^^X^^X^_________| ______",
        "^^X^^X^__&bbbbb_| ______",
        "^-x--x-_________| ______",
        "^^X^^X^__&bbbbb_| ______",
        "^^X^^X^_________| ______",
        "^-x--x-__&bbbbb_| ______",
        "^^X^^X^|________| ______",
        "^^H^^H^|_&bbbbb_| ______",
        "^^^^^^^|________| ______",
        "^^^^^^^||||||||||       "
      ],
      "palettes": [
        "railroad_station"
      ]
    }
  }
]
