[
  {
    "type": "mapgen",
    "om_terrain": [ "railroad_level_crossing" ],
    "method": "json",
    "weight": 100,
    "object": {
      "fill_ter": "t_dirt",
      "rows": [
        "   ]^X^^X^^  ^^X^^X^]   ",
        " 1 ]#x##x#^  ^#x##x#] 1 ",
        "   ]^X^^X^^  ^^X^^X^]   ",
        "]]]]^X^^X^^  ^^X^^X^]]]]",
        ".....X..X......X..X.....",
        ".....X..X......X..X.....",
        ".....X..X......X..X.....",
        ".....X..X......X..X.....",
        ".....X..X......X..X.....",
        ".....X..X......X..X.....",
        ".....X..X......X..X.....",
        ".:::.X::X::::::X::X.:::.",
        ".....X..X......X..X.....",
        ".....X..X......X..X.....",
        ".....X..X......X..X.....",
        ".....X..X......X..X.....",
        ".....X..X......X..X.....",
        ".....X..X......X..X.....",
        ".....X..X......X..X.....",
        "]]]]^X^^X^^  ^^X^^X^]]]]",
        "   ]^X^^X^^  ^^X^^X^]   ",
        " 1 ]#x##x#^  ^#x##x#] 1 ",
        "   ]^X^^X^^  ^^X^^X^]   "
      ],
      "palettes": [
        "railroad"
      ]
    }
  }
]
