[
  {
    "type": "mapgen",
    "method": "json",
    "om_terrain": "monorail_station_z0",
    "object": {
      "fill_ter": "t_dirt",
      "rows": [
        "]]]]]]]]]]]]]]]]]]]]]]]]",
        "]OOOOOOOOOOOOOOOOOOOOOO]",
        "]O____________________O]",
        "]O____________________O]",
        "]O____________________O]",
        "]O____________________O]",
        "]O____________________O]",
        "]O____________________O]",
        "]O____________________O]",
        "]O____________________O]",
        "]OOOOOOOOOOOOOOOOOOOOOO]",
        "]O_________<<_________O]",
        "]O_________<<_________O]",
        "]OOOOOOOOOOOOOOOOOOOOOO]",
        "]O____________________O]",
        "]O____________________O]",
        "]O____________________O]",
        "]O____________________O]",
        "]O____________________O]",
        "]O____________________O]",
        "]O____________________O]",
        "]O____________________O]",
        "]OOOOOOOOOOOOOOOOOOOOOO]",
        "]]]]]]]]]]]]]]]]]]]]]]]]"
      ],
      "palettes": [ "monorail", "monorail_station" ]
    }
  },
  {
    "type": "mapgen",
    "method": "json",
    "om_terrain": "monorail_station_z1",
    "object": {
      "fill_ter": "t_open_air",
      "rows": [
        "                        ",
        " ###################### ",
        " #____________________# ",
        " #____________________# ",
        " #____________________# ",
        " #____________________# ",
        " #____________________# ",
        " #____________________# ",
        " #____________________# ",
        " #____________________# ",
        " ###################### ",
        " #_________>>_________# ",
        " #_________>>_________# ",
        " ###################### ",
        " #____________________# ",
        " #____________________# ",
        " #____________________# ",
        " #____________________# ",
        " #____________________# ",
        " #____________________# ",
        " #____________________# ",
        " #____________________# ",
        " ###################### ",
        "                        "
      ],
      "palettes": [ "monorail", "monorail_station" ]
    }
  }
]
